###################
#1 +    #        3#
#  +    #         #
#+++    #         #
#       #         #
#       #         #
#       u         #
#       #         #
#       #         #
#       #         #
#       #         #
#2      #        4#
###################