###################
#1 +    #        3#
#  +    #         #
#+++    #      +++#
#   +++ # +++     #
#       #         #
# +++   u     +++ #
#       #         #
#   +++ # +++ u   #
#       #         #
# +++   #     +++ #
#2      #        4#
###################