Indestructable:Textures/Tiles/BrickWall
Destructable:Textures/Tiles/WoodenWall
Floor:Textures/Tiles/GrassTile

StartMap
###################
#1       #       3#
# ++#+   #   +#++ #
#  ###   #   ###  #
#  +#+++ # +++#+  #
#  +    ###    +  #
#+##### +u+ #####+#
#  +    ###    +  #
#  +#+++ # +++#+  #
#  ###   #   ###  #
# ++#+   #   +#++ #
#2       #       4#
###################