Indestructable:Textures/Tiles/RedAsphaltTile
Destructable:Textures/Tiles/BlueBlackWoodTile
Floor:Textures/Tiles/BlackAsphaltTile
Music:Audio/Songs/guitar-ingame

StartMap
###################
#1       #       3#
#   #  # + #  #   #
#  ###+## ##+###  #
#   #   ###   #   #
#   #    +    #   #
#++## # +u+ # ##++#
#   #    +    #   #
#   #   ###   #   #
#  ###+## ##+###  #
#   #  # + #  #   #
#2       #       4#
###################
EndMap