Indestructable:Textures/Tiles/IceCubeTile
Destructable:Textures/Tiles/CrackedIceCubeTile
Floor:Textures/Tiles/SnowTile
Music:Audio/Songs/wobble-synth

StartMap
###################
#1 + 2 +   + 3 + 4#
#  #   #   #   #  #
# ####+## ##+#### #
#      #   #      #
##  #    +    #  ##
##+##   #u#   ##+##
#   + #  +  # +   #
#   #   ###   #   #
# ###++## ##++### #
#   #  # + #  #   #
##       #       ##
###################
EndMap
