Indestructable:Textures/Tiles/IceCubeTile
Destructable:Textures/Tiles/CrackedIceCubeTile
Floor:Textures/Tiles/SnowTile

StartMap
###################
#1 # 2 # u # 3 # 4#
#  #   #   #   #  #
# ####+## ##+#### #
#      #   #      #
#   #    #    #   #
##### # ### # #####
#   #    +    #   #
#   #   ###   #   #
#  ##++## ##++##  #
#   #  # + #  #   #
#        #        #
###################
EndMap
